NO ./textures/limonagrio.png
SO ./textures/champi.png
WE ./textures/planta.png
EA ./textures/cerezo.png
F 45,54,70
C 20,20,20

1111111111111111111111
1000000000000000000001
1000000000000000000001
1000000000000000000001
1000000000000000000001
1000000000000000000001
10000000000N0000000001
1000000000000000000001
1000000000000000000001
1000000000000000000001
1000000000000000000001
1000000000000000000001
1000000000000000000001
1000000000000000000001
1000000000000000000001
1000000000000000000001
1000000000000000000001
1000000000000000000001
1000000000000000000001
1000000000000000000001
1111111111111111111111