NO ./textures/limonagrio.png
SO ./textures/limonagrio.png
WE ./textures/limonagrio.png
EA ./textures/limonagrio.png
F 45,54,70
C 20,20,20

11111111111
10000000001
10000000001
10000000001
1000S000001
10000000001
10000000001
10000000001
11111111111